11010111
1010x011
00000101
11101101
11y00110
